{
	"enemies": [
		{
			"pos": [
				"8 * TILE_SIZE",
				"3 * TILE_SIZE"
			],
			"vel": [
				1.23,
				0
			]
		},
		{
			"pos": [
				"(NUM_TILES_IN_ROW-3) * TILE_SIZE",
				"4 * TILE_SIZE"
			],
			"vel": [
				-1.3,
				0
			]
		},
		{
			"pos": [
				"2 * TILE_SIZE",
				"7 * TILE_SIZE"
			],
			"vel": [
				1.1,
				0
			]
		},
		{
			"pos": [
				"(NUM_TILES_IN_ROW-10) * TILE_SIZE",
				"8 * TILE_SIZE"
			],
			"vel": [
				-1.1,
				0
			]
		},
		{
			"pos": [
				"16 * TILE_SIZE",
				"11 * TILE_SIZE"
			],
			"vel": [
				1.3,
				0
			]
		},
		{
			"pos": [
				"(NUM_TILES_IN_ROW-2) * TILE_SIZE",
				"12 * TILE_SIZE"
			],
			"vel": [
				-1.23,
				0
			]
		}
	],
	"tiles": [
		1,1,1,1,1,1,1,1,1,1,1,1,1,1,1,1,1,1,1,1,1,1,1,1,1,1,1,1,
		1,1,1,1,1,1,1,1,1,1,1,1,1,1,1,1,1,1,1,1,1,1,1,1,1,1,1,1,
		0,0,0,0,0,0,0,0,0,0,0,0,0,0,0,0,0,0,0,0,0,0,0,0,0,0,0,0,
		2,2,2,2,2,2,2,2,2,2,2,2,2,2,2,2,2,2,2,2,2,2,2,2,2,2,2,2,
		2,2,2,2,2,2,2,2,2,2,2,2,2,2,2,2,2,2,2,2,2,2,2,2,2,2,2,2,
		0,0,0,0,0,0,0,0,0,0,0,0,0,0,0,0,0,0,0,0,0,0,0,0,0,0,0,0,
		0,0,0,0,0,0,0,0,0,0,0,0,0,0,0,0,0,0,0,0,0,0,0,0,0,0,0,0,
		2,2,2,2,2,2,2,2,2,2,2,2,2,2,2,2,2,2,2,2,2,2,2,2,2,2,2,2,
		2,2,2,2,2,2,2,2,2,2,2,2,2,2,2,2,2,2,2,2,2,2,2,2,2,2,2,2,
		0,0,0,0,0,0,0,0,0,0,0,0,0,0,0,0,0,0,0,0,0,0,0,0,0,0,0,0,
		0,0,0,0,0,0,0,0,0,0,0,0,0,0,0,0,0,0,0,0,0,0,0,0,0,0,0,0,
		2,2,2,2,2,2,2,2,2,2,2,2,2,2,2,2,2,2,2,2,2,2,2,2,2,2,2,2,
		2,2,2,2,2,2,2,2,2,2,2,2,2,2,2,2,2,2,2,2,2,2,2,2,2,2,2,2,
		0,0,0,0,0,0,0,0,0,0,0,0,0,0,0,0,0,0,0,0,0,0,0,0,0,0,0,0,
		1,1,1,1,1,1,1,1,1,1,1,1,1,1,1,1,1,1,1,1,1,1,1,1,1,1,1,1,
		1,1,1,1,1,1,1,1,1,1,1,1,1,1,1,1,1,1,1,1,1,1,1,1,1,1,1,1
	]
}
